~~~~~~~~~~~~~~~~~~~~~~~~~~~~~~
~~~~~~~~~~~~~~~~~~~~~~~~~~~~~~
~~~~........~~~~~~~~~~~~~~~~~~
~~~~........~~~~~~~~~~~~~~~~~~
~~~~........~~~~~~~~~~~~~~~~~~
~~~~........~~~~~~~~~~~~~~~~~~
~~~~........~~~~~~~~~~~~~~~~~~
~~~~......................~~~~
~~~~......................~~~~
~~~~~~~~~~~~~~~~~~~~......~~~~
~~~%%%%%%~~~~~~~~~~~......~~~~
~~~%%%%%%~~~~~~~~~~~......~~~~
~~~%%%%%%~~~~~~~~~~~......~~~~
~~~~~~~~~~~~~~~~~~~~~~~~~~~~~~
~~~~~~~~~~~~~~~~~~~~~~~~~~~~~~

